7 7
#S#####
#     #
###D# #
# #   #
#   ###
#     #
#####E#
